h,,,,,,,,,,,n
p,,,,,,,,,rzn
zzozozozo,rzn
l,,,,,,,,,rzn
l,rbbbl,rzzzn
l,,,,,,,ozzzn
zzzz,zzzzzzzn
l,,,,,,,,,,,n
o,o,ozzzzzzzn
,,,,,,,,,,,,n
o,z,o,z,o,z,n
,,,,,,,,,,,,n
s,o,o,s,o,o,n
,,,,,,,,,,,,n
zzzzzzzo,ozzn
s,,,,,,,,,,,n
szz,ozzzzozzn
s,,,,,,,,,,sn
,,,,,,,,,,,,n
,,,,,,,,,,,,n
z,,,,,,,,,,fn
