h,,,,,,,,,,,n
p,,,,,,,,,rxn
xxoxoxoxo,rxn
l,,,,,,,,,,,n
l,rbbbl,rxxxn
l,,,,,,,oxxxn
xxxx,xxxxxxxn
l,,,,,,,,,,,n
o,o,oxxxxxxxn
,,,,,,,,,,,,n
o,x,o,x,o,x,n
,,,,,,,,,,,,n
s,o,o,s,o,o,n
,,,,,,,,,,,,n
xxxxxxxo,oxxn
s,,,,,,,,,,,n
sxx,oxxxxoxxn
s,,,x,,,,,,sn
,,,,,,,,,,,,n
,,,,,,,,,,,,n
x,,,,,,,,,,fn
