h1,,,,,,,,,,n
poy,,,,,,,,on
,,y,,,,,o,,,n
,,y,ryyyyyl,n
,,y,ry,,,yl,n
,oy,ry,o,yl,n
,,y,ry,o,yl,n
,,y,ry,o,yl,n
l,y,ry,o,y,,n
,,y,ry,o,y,on
,,y,rygy,y,rn
,oy,ryyy,y,rn
,,y,y,,,,y,on
,,y,y,o,yy,,n
o,y,y,o,yyl,n
,,y,y,,,yyl,n
,,y,,y,yyyl,n
,oyo,,,oyyl,n
,,yyyyyyyyl,n
,,,,,o,,,,,,n
o,,o,,,o,,,on
